{
    "texture": "tileset",
    "width": 31,
    "height": 21,
    "tileWidth": 32,
    "tileHeight": 32,
    "back": [
        10,10,10,10,10,10,10,10,10,10,10,10,10,8,17,19,22,1,14,14,14,14,14,14,14,14,14,14,14,14,14,
        10,12,9,9,9,9,9,9,9,9,9,9,9,6,23,23,23,2,3,3,3,3,3,3,3,3,3,3,3,13,14,
        10,8,23,23,23,23,23,23,23,23,23,23,23,23,23,23,23,23,23,23,23,23,23,23,23,23,23,23,23,1,14,
        10,8,23,23,23,23,23,23,23,23,23,23,23,23,23,23,23,23,23,23,23,23,23,23,23,23,23,23,23,1,14,
        10,8,23,23,23,23,23,23,23,23,23,23,23,23,23,23,23,23,23,23,23,23,23,23,23,23,23,23,23,1,14,
        10,8,23,23,23,23,23,23,23,23,23,23,23,23,23,23,23,23,23,23,23,23,23,23,23,23,23,23,23,1,14,
        10,8,23,23,23,23,23,23,23,23,23,23,23,23,23,23,23,23,23,23,23,23,23,23,23,23,23,23,23,1,14,
        10,8,23,23,23,23,23,23,23,23,23,23,23,23,23,23,23,23,23,23,23,23,23,23,23,23,23,23,23,1,14,
        9,6,23,23,23,23,23,23,23,23,23,23,23,23,23,23,23,23,23,23,23,23,23,23,23,23,23,23,23,2,3,
        20,23,23,23,23,23,23,23,23,23,23,23,23,23,23,23,23,23,23,23,23,23,23,23,23,23,23,23,23,23,15,
        21,23,23,23,23,23,23,23,23,23,23,23,23,23,23,23,23,23,23,23,23,23,23,23,23,23,23,23,23,23,16,
        22,23,23,23,23,23,23,23,23,23,23,23,23,23,23,23,23,23,23,23,23,23,23,23,23,23,23,23,23,23,17,
        11,7,23,23,23,23,23,23,23,23,23,23,23,23,23,23,23,23,23,23,23,23,23,23,23,23,23,23,23,4,5,
        10,8,23,23,23,23,23,23,23,23,23,23,23,23,23,23,23,23,23,23,23,23,23,23,23,23,23,23,23,1,14,
        10,8,23,23,23,23,23,23,23,23,23,23,23,23,23,23,23,23,23,23,23,23,23,23,23,23,23,23,23,1,14,
        10,8,23,23,23,23,23,23,23,23,23,23,23,23,23,23,23,23,23,23,23,23,23,23,23,23,23,23,23,1,14,
        10,8,23,23,23,23,23,23,23,23,23,23,23,23,23,23,23,23,23,23,23,23,23,23,23,23,23,23,23,1,14,
        10,8,23,23,23,23,23,23,23,23,23,23,23,23,23,23,23,23,23,23,23,23,23,23,23,23,23,23,23,1,14,
        10,8,23,23,23,23,23,23,23,23,23,23,23,23,23,23,23,23,23,23,23,23,23,23,23,23,23,23,23,1,14,
        10,10,11,11,11,11,11,11,11,11,11,11,11,7,23,23,23,4,5,5,5,5,5,5,5,5,5,5,5,14,14,
        10,10,10,10,10,10,10,10,10,10,10,10,10,8,15,18,20,1,14,14,14,14,14,14,14,14,14,14,14,14,14
    ],
    "front": [],
    "tiles": [
        {
            "value": 1,
            "collision": "0x1111"
        },
        {
            "value": 2,
            "collision": "0x1111"
        },
        {
            "value": 3,
            "collision": "0x1111"
        },
        {
            "value": 4,
            "collision": "0x1111"
        },
        {
            "value": 5,
            "collision": "0x1111"
        },
        {
            "value": 6,
            "collision": "0x1111"
        },
        {
            "value": 7,
            "collision": "0x1111"
        },
        {
            "value": 8,
            "collision": "0x1111"
        },
        {
            "value": 9,
            "collision": "0x1111"
        },
        {
            "value": 10,
            "collision": "0x1111"
        },
        {
            "value": 11,
            "collision": "0x1111"
        },
        {
            "value": 12,
            "collision": "0x1111"
        },
        {
            "value": 13,
            "collision": "0x1111"
        },
        {
            "value": 14,
            "collision": "0x1111"
        },
        {
            "value": 15,
            "collision": "0x1111"
        },
        {
            "value": 16,
            "collision": "0x1111"
        },
        {
            "value": 17,
            "collision": "0x1111"
        },
        {
            "value": 18,
            "collision": "0x1111"
        },
        {
            "value": 19,
            "collision": "0x1111"
        },
        {
            "value": 20,
            "collision": "0x1111"
        },
        {
            "value": 21,
            "collision": "0x1111"
        },
        {
            "value": 22,
            "collision": "0x1111"
        }
    ]
}